NO ./path_to_the_north_texture
SO ./path_to_the_south_texture
WE ./path_to_the_west_texture
EA ./path_to_the_east_texture

F 150,150,150
C 100,100,100

1111111111
1000000001
1000000001
10000N0001
1000000001
1000000001
1000000001
1000000001
1000000001
1111111111
