NO ./path_to_the_north_texture
SO ./path_to_the_south_texture
WE ./path_to_the_west_texture
EA ./path_to_the_east_texture

F 150,150,150
C 100,100,100

       1111111
     11100000111
    1100000000011
   100000000000001
  10000000000000001
 1100000000000000011
 1000000000000000001
110000000000000000011
100000000000000000001
100000000000000000001
1000000000N0000000001
100000000000000000001
100000000000000000001
110000000000000000011
 1000000000000000001
 1100000000000000011
  10000000000000001
   100000000000001
    1100000000011
     11100000111
       1111111
