NO ./assets/textures/debug_no.xpm
SO ./assets/textures/debug_so.xpm
WE ./assets/textures/debug_we.xpm
EA ./assets/textures/debug_ea.xpm
F 150,150,150
C 100,100,100

        1111111111111111111111111
        100D000000110000000000001
        1011000001110000000000001
        1001000000D00000000000001
111111111011000001110000000000001
10000000001100000111D11111D111111
1111D111111111D11100000010001
11110111111111011101010010001
11000000110101011100000010001
10000000000000001100000010001
10000000000000001101010010001
11000001110101011111011110N0111
11110111 1110101 101111010001
11111111 1111111 111111111111
